The opponent
____________________
____________________
____________________
____________________
____________________
____________________
____________________
___________x____o_oo
_________####x######
__s__xx_x####x######
####################
####################
####################
####################
####################
