____________________
____________________
____________________
____________________
____________________
____________________
____________________
____________________
____________________
____________________
____________________
_s_____#o_o#__x_____
####################
####################
####################