____________________
____________________
____________________
____________________
____________________
____________________
____________________
____________________
__s___o__o____o_____
##########_#########
##########_#########
##########_#########
####################
####################
####################