You know the rules
____________________
____________________
____________________
____________________
____________________
____________________
____________________
______________o_____
____s____o_o_#######
####################
####################
####################
####################
####################
####################