____________________
____________________
____________________
____________________
____________________
____________________
________________x_xx
___________o_oo#####
__s_[_[__[##########
####################
####################
####################
####################
####################
####################