____________________
____________________
____________________
____________________
____________________
____________________
____________________
____________________
__[_[_s_____________
##-#####____########
##-#####____########
##-#####____########
##-########_########
##-_________########
####################