____________________
____________________
____________________
____________________
____________________
____________________
____________________
___________o_#######
___________o########
____s____o_#########
####################
####################
####################
####################
####################