This is a platformer...
____________#_______
____________#_______
__________o_#_______
_____--__##_________
___#________________
_____#______________
_______#__#_o_______
_________##_##_#____
_________________#__
___________________#
________#__o#____###
__s__##-#__##__#####
#######-___#########
####################
####################
