____________________
____________________
____________________
____________________
____________________
____________________
___________o_oo_____
__________##########
___s__x_xx##########
####################
####################
####################
####################
####################
####################