Diagonals work too
____________#_______
____________#_______
_______o____#_______
_____-#####________-
_____-_o__#________-
_____-###_#_#_o____-
_____-______####___-
_____-_____________#
_____-______########
__s__-_____#########
####################
####################
####################
####################
####################
