__________________##
__________________##
__________________##
__________________##
_____________o__x_##
__________#_#####_##
________#____o__x_##
_______##########_##
__s__#_______o__x_##
#################_##
#################_##
#################_##
#################_##
#################_##
####################