The duel begins
_________________###
_________________###
_________________###
_________________###
_____________o_x_###
__________#_####_###
________#____o_x_###
_______#########_###
__s__#_______o_x_###
################_###
################_###
################_###
################_###
################_###
####################
