You know the rules
________________________________
________________________________
________________________________
________________________________
________________________________
________________________________
________________________________
________________________o_______
____s________o*O*###############
################################
################################
################################
#############___-___############
###########___________##########
################################
################################
################################
################################