...a puzzle platformer
____________________
____________________
____________________
____________________
____________________
_______________o____
_______________#-___
____o___________-___
____-_____#--__o-___
__#_____s_##########
#########o##########
####################
####################
####################
####################
